


SO   ./textures/xpm/wall.xpm

   NO   ./textures/xpm/wall.xpm
           
           
           WE   ./textures/xpm/wall.xpm
           EA    ./textures/xpm/wall.xpm


             F  255,255,255

C  132, 203, 240












        1111111111111111111111111    
        1000000000110000000000001
        1011000001110000000000001
        100100000000000000000001
11111111101100001110000000000001               1
100000000011000001110111111111111
1111011111  1111011100000010001
111101111111110111010100100011
  11000000110101011100000010001
  100000N0000000001100000010001
  10000000000000001101010010001
  1100000111010101111101111000111
  11110111 1110101 101111010001
  11111111 11111111111111111111


