


SO   ./textures/xpm/wall.xpm

   NO   ./textures/xpm/wall.xpm
           
           
           WE   ./textures/xpm/wall.xpm
           EA    ./textures/xpm/wall.xpm


             F  ./textures/xpm/wall.xpm

C  132      ,        203 , 78













11111111111111111
  110000001101011
  1000000N0000001
  111111111111111


